 #####################################################################
 #   %  #################### #     #       #####################     #
 #      #                 ## # #   # #   # #                         #
 #      # ############### ##   #   # #   # # ################# #     #
 #      # #             # ## #### ##### ## # #               # #     #
 #      # # ########### # ## #     #     # # # ## ########## # #     #
 #      # # #         # # ## ## ######## # # # #           # # #     #
 #      # # # # ##### # # ## #     #     # # # # ######### # # #     #
 #      # # # #     # # # ## # ####### ### # # # #       # # # #     #
 #      # # # #     # # # ## #     #     # # # # # ##### # # # #     #
 #      # # # # # # # # # ## #### ###### # # # # # #   # # # # #     #
 #      # # # # # # # # # ## #     # ##  # # # # # #   # # # # #     #
 #        # # # ### # # # ## ## # ##     # # # # # #$$$# # # # #     #
 #      # # # #     #   # ## #     # ##### # # # #       # # # #     #
 #      # # # #     # # # ## ####  #     # # # # #       # # # #     #
 #     <# # # ####### # # ## #     ##### # # # # ####### # # # #>    #
 #      # # #         # # ## #     #   # # # # #           # # #     #
 #>     # # ########### # ## ## ######   # # # ############# # #    <#
 #      #               # ## ## #  @     # # #                 #     #
 #     <# ############### ## ## #  #     # # ################# #>    #
 #      #                 ## ## ## ###   # #                   #     #
 #      #################### #     ####  # #####################     #
 #                           #     #######                           #
 #####################################################################
