 #####################################################################
 #####################################################################
 #  #   #   #   #   #   #   #                 #   #   # ###   #   #  #
 ## # #   # # # #   # ### # #  # ## ### ### # # #   #   #   # # # # ##
 ##       #   #       #   #                 #   #   ##  #   #   #   ##
 ##   ### #   ###  ## ### # # # # ### ### # ### # # #     #   ### ####
 #  #   #   #   #   #   #   #         #   #   #   #   #   #   #   #  #
 ## # # # # # # #   # ### # #   # # ##    # # ###   # # # #     ### ##
 ##       #   #   #   #   #   #         #   #   #   #   #   #   #   ##
 ## #   # # ### #  ## # # # # # # ### # # # #   # # ###   # # # # # ##
 #  #   #   #       #   #   #         #   #   #           #   #   #  #
 ## # ### # # # # ### # # # #  ## #$# # # # # #   #   # # #     # # ##
 ##   #   #  ##   #   #   #       #@#   #   #   #       #       #   ##
 ## #   #     # # #   ##  # # # # #$#   ### # # # # #   #     # # # ##
 #  #   #   #   #   #       #   #     #   #   #   #   #   #   #   #  #
 ## ### #   #     # # #   # # # # ### # # # #   # # # # # ###   # # ##
 ##       #   #   #   #   #   #         #   #   #       #   #   #   ##
 ## # ###   ###     ### #   # # ### ### # #   # # # #   # #    ## # ##
 #  #   #   #   #   #   #   #             #   ##      #   #   #   #  #
 ##   #   # # # #   #   #   # #####   ### # #   # # # ###     # # ####
 ##       #   #           #      ##         # #         #   #   #   ##
 ## # # # # # # # # # ### # ###   # ### ###%# # #   # # # # # ### # ##
 #####################################################################
 #####################################################################
