 #####################################################################
 #####################################################################
 ##     #    # ##   #            #     #       # #   #           #####
 ## ##  # ##   #  # #   ######## #     # ##### # # #   #   #####    ##
 ##  ####  ### # #####  # ###    #    ## ##    #   ######  #   # ## ##
 ##     #    #      ###    # ######  ##   # #    # #   ###       #  ##
 ##  #          # #  ## # ##      ####      ## ## ## #####      ## ##
 ##  ##       #   ## #  #  ####     #     #######   # #             ##
 ##  #####   ###  #    ###     ##   #     #           #   #     # ####
 ### #   #   # #  # ##   # ##   ## $@$    # ## ### ####   #     #  ###
 ### #   ##### #  #### ### ##    #  $#         #    ##    #     #   ##
 ##    #  ## # #       #    #       #     # # #  ## ###   #    #######
 ###   ##  #   #    #  # ####       #   ##### # ### ##    #    #    ##
 ### # #   #   #   ## #### #  #   ##### # #   #           # #####   ##
 ### ###           #  # #    ##       ###   ######    #   #     #   ##
 ### ######      # #  #   ######  #  ##     # #       #   #         ##
 ##     #        ###  #      #### #  ##  #  #   ### ###   ##### #   ##
 ##        #            ####         #  ## ## # # ### ### #  #  #   ##
 ## ###### #    ## # ##  # ### #######  ##    # #   # # # #  ##     ##
 ## #    # ####### #  #  # # # #     #####    ###       # ##    # ####
 ## ###  #  #   ##### #  # # ### ###        #   #### ## # ##  # #   ##
 ##   #             #                 #%### #        #       ## #   ##
 #####################################################################
 #####################################################################
