 #####################################################################
 #       % ###                               ###                     #
 #     ### ### ###                       ### ### ###                 #
 #     ###     ###                       ###     ###                 #
 # ### ###     ### ###               ### ###     ### ###             #
 # ###             ###               ###             ###             #
 # ###             ### ###           ###             ### ###         #
 #                     ###                               ###         #
 ###                   ### ###     ###                   ### ###     #
 ###                       ###     ###                       ###     #
 ###                       ### ###$###                       ### ### #
 #>                            ### $ $                           ### #
 # ###                         ###$@$###                         ### #
 # ###                           $ $ ###                             #
 # ### ###                       ###$### ###                       ###
 #     ###                       ###     ###                       ###
 #     ### ###                   ###     ### ###                   ###
 #         ###                               ###                     #
 #         ### ###             ###           ### ###             ### #
 #             ###             ###               ###             ### #
 #             ### ###     ### ###               ### ###     ### ### #
 #                 ###     ###                       ###     ###     #
 #                 ### ### ###                       ### ### ###     #
 #####################################################################
