 #####################################################################
 #####################################################################
 #          ##### #  ###      # ####### ##   ##  # ######           ##
 #   ##     ##### #  ######## # ####    #   #  #   ##     ###### #  ##
 # #### #  #    $ #  #        # ###     # #### ### #             #  ##
 # ##   ###   # $    #        # ### ### # ####   # ###  #        #  ##
 #  #  ####   # # @  # ##### ##       # #######    #   ###########   #
 ####  ##### ## #  ### ##### ####  #### #    ##### # # ##        # ###
 #  #  ##    ## #$#  # ##    ####  ####   ## ##    # # ##  #    ## # #
 # ### ##  # ## #      ##### ####  #### ####    ## ### ######  ##  # #
 #        ## ##   ########## ##       # # ## ## ## ##  #####  ##   # #
 #       ### ###  #   ###### ## ## #  # # ## #     #  ### ## ##    # #
 #      #### # #  #   ##        ## ## # # ## # ##    #### ## #   #   #
 # ###  #### # # ##  ### ###  ####  # # # ## # ###  #####        ### #
 # #### ###### #  #  ##  # #        # # # ## # ### ####    ##   #### #
 # #### ### ## # ##  ## ## #  ####  # #   ## ##### #      ###   ###  #
 # ###      ##    #  ## ## #####    # # # ##  #### #  ### ###  ####  #
 # ###      ## ## #   # ## # # #  ### #   ##       ###### ###  ####  #
 #  ## #### ##  # ### #  #   #    ###### ###       #   ## ##      #  #
 ## ## #### ## ## ### #  ### # #  ##   #     #####     ## ## #### #  #
 ## ##         ## #       ## # #  ## # # ##   ###  ###    ## #### #  #
 ##    ######     # ##### ##   #     #%# ####     #### #     ####    #
 #####################################################################
 #####################################################################
