 #####################################################################
 #####################################################################
 #        #########        ###    # #    #     #      #        #     #
 #    ### #### #### ####    #  ##   #  ####  ######   #    #   #  #  #
 #  # ### ###     # ####  #   ##### #  #%### #####    ## ### # # ### #
 ######## ##   #  #      ## ####  # #    ##  ####        ### #   ##  #
 ######   #    ##  # ## ### #     # # #####   ##  #   ########  ###  #
 #  ##      ## ### # ##   #    ## # #  #  ### #  ###    ####         #
 #   # #   ### ### # ###    ### # #             #####          #   # #
 # #   ## ###      # #####$###  #    #####################$###$### # #
 # ## ######   ##  #  ## #     ##$#$$##  ####    ###       ##  #   # #
 # ## # ####  ###     ## #  #  #  #  ###  # #     ##  ##  ##  ## # # #
 # #     ##  ###   ##     ######  #  #### # #  #     ##  ##      # # #
 # ##  #  ## ##   ######        ###  ####     ##    ##  ##   ####### #
 # #  ### ## ##  ###     # # ######  ####### ####  ##  ##   ####     #
 #   #### ## #  ###      ###    ##  ##     # # ####   ###  ##     ## #
 #    ### #  # #### ###### # #  #  @ #   # #   ####  ## #     ##  ## #
 # ## ###       ### # #      #  ##  ##   #   #      ##    ## #### #  #
 # ## ##  ##  #  ## #      #######  ########### #  ##   #  #    # #  #
 # ## ## ##  ###  ###  # # #  # ######          # ##   ###   ##   ## #
 #########  #####  ## #### #  # #  #   ############   #####  ## #### #
 ##        #######    #            #                   ###        ## #
 #####################################################################
 #####################################################################
