 #####################################################################
 #####################################################################
 #   #  # #  # #  # #    #         #         # #    #  # #  # #  #   #
 #      ###  ###  # #  ### ####### ######### ###  ###  # #   ##  #   #
 #      #    # #       # # #               # #    #    # #           #
 #   #  ##     #   ##    # # ############# #   #  # #  #    ###  #   #
 #   #  #    #         #   # #           # # # #       # #  #    #   #
 #   #    #  ##   ###  ### # # # ####### # # # #  ###  ###    #  #   #
 #   #    #  # #  # #  # # # # #       # # #   #  # #  # #  # #      #
 #      #    ###  ###  ### # # #  # #  # # # #     ##  ###  ###  #   #
 #   #  # #    #  #        # # # ##$## # # # # #    #    #           #
 #   #   #   # #  # #  ### # # #  $@$  #   # ###  #    # #  # #  #   #
 #   #    #  #         # # # # # ##$## # # # # #  # #  #    # #  #   #
 #   #   ##  ###  ###  #   # # #  # #  # # #      ###  ##     #  #   #
 #           # #  # #  # # # # #       # # # # #    #  # #  # #  #   #
 #   #  ###    #  ###  # # #   ####### # # # ###  ###  ###  ###      #
 #   #  #    # #         # # #           # # # #  #    #    #        #
 #      # #  # #  ###  ### # ############# # # #  # #    #    #  #   #
 #   #    #  #    # #    # #               # # #  # #  # #  # #  #   #
 #   #  # #  # #  ###  #   ############# ### #    #    ###  ###      #
 #                #    #%#         #         # #    #  # #  #    #   #
 #   #  ##   ###    #  ###         #           #  ###  ###    #      #
 #####################################################################
 #####################################################################
