 #####################################################################
 #                               #####                               #
 #                               #   #                               #
 #                               # @ #                               #
 #    ##########^#################   #################^##########    #
 #    ############################   ############################    #
 #    #                     ####        ###                     #    #
 #    #                     #### ###### ###                     #    #
 #    #                     ###  ###### ###                     #    #
 #    #  #################  ### ######  ###  #################  #    #
 #    #  #################  ### ######  ###  #################  #    #
 #    #  ##                 ###        ####                 ##  #    #
 #    #  ##                 ###        ###################  ##  #    #
 #    #  ##  ###################### ######################  ##  #    #
 #    #  ##                 ####### ########                ##  #    #
 #    #  #############    #$####### ########     #############  #    #
 #    #             ##    #   ###     %###       #              #    #
 #    #             ##    #   ###  #   ###       #              #    #
 #    #             ##    #   <##  #   ##>       #              #    #
 #    ############  ##    #   ###  #   ###       #   ############    #
 #    ############  ##    #   ###      ###       #   ############    #
 #                  ##    #   #####  #####       #                   #
 #          ^       ##    #                      #        ^          #
 #####################################################################
