 #####################################################################
 #####################################################################
 ##     #    # ##   #            #     #       # #   #           #####
 ## ##  # ##   #  # #   ######## #     # ##### # # #   #   #####    ##
 ##  ####  ### # #####  # ###    #    ## ##    #   ######  #   # ## ##
 ##     #    #      ###    # ######  ##   # #    # #   ###       #  ##
 ##  #          # #  ## # ##      ####      #^# ## ## #####      ## ##
 ##  ##       #   ## #  #  ####     #     #######   # #             ##
 ##  #####   ###  #    ###     ##   #     #           #  <#     # ####
 ### #   # ^ # #  # ##   # ##   ## $@$    # ## ### ####   #     #  ###
 ### #   ##### #  #### ### ##    #  $#         #    ##    #     #   ##
 ##    #  ## # #       #    #       #     # # #  ## ###   #    #######
 ###   ##  #   #    #  # #### ^     #   ##### # ### ##    #    #    ##
 ### # #   #   #   ## #### #  #   ##### # #   #           # #####   ##
 ### ###           #  # #    ##       ###   ######    #   #     #   ##
 ### ######      # #  #   ######  #  ##     # #       #   #         ##
 ##     #        ###  #      #### #  ##  #  #   ### ###   ##### #   ##
 ##        #            ####         #  ## ## # # ### ### #  #  #   ##
 ## ###### #   ^## # ##  # ### #######  ##    # #   # # # #  ##     ##
 ## #    # ####### #  #  # # # #     #####    ###       # ##    # ####
 ## ###  #  #   ##### #  # # ### ###        #   #### ## # ##  # #   ##
 ##   #             #                <#%###^#        #       ## #   ##
 #####################################################################
 #####################################################################
