 #####################################################################
 #                                       $$                          #
 #                                 %     $$                          #
 #                                       $$                          #
 #    ########################$$$$$$$$$$$########################    #
 #    ########################           ########################    #
 #    ########################           ########################    #
 #                           #           #                           #
 ########################    #           #    ########################
 ########################    #           #    ########################
 ########################    #           #    ########################
 #                           #     >     #                           #
 ##      #####################           #####################      ##
 #####      ##################           ##################      #####
 ########      ###############     <     ###############      ########
 ###########      ############           ############      ###########
 ##############      #########           #########      ##############
 #################      ######     >     ######      #################
 ####################      ###           ###      ####################
 #################           #           #           #################
 ##############             ##           ##             ##############
 ###########             #####           #####             ###########
 #                    ########     @     ########                    #
 #####################################################################
