 #####################################################################
 #####################################################################
 #####################                           ######            ###
 #%################### ######## ### ############ ###### ##############
 # ################### ######## ### ############ ###### ##############
 #           #########$######## ### ########     ###### ##############
 # ######### @         ######## ### ######## ###                    ##
 #           #########$######## ### ######## ### # #### #### ##### ###
 # ########## ######## ######## ### ######## ### # #### #### ##### ###
 #            ########    ##                 ### # #### #### ##### ###
 # ########## ########    ##    ############ ### # #### #### ##### ###
 #            ######## ##### ##              ### # #### #### ##### ###
 # ########## ######## ##### ## ############ ###   #### #### ##### ###
 #            ######## ##### ## ############ ### # #### #### ##### ###
 # ########## ######## ##### ## ############ ### # #### #### ##### ###
 #            ######## ##### ##                  # #### #### ##### ###
 # ########## ######## ##### ## #################  ####         ## ###
 #            ######## ##### ## ######## ######### #### ####### ## ###
 # ########## ######## ##### ## ######## ######### #### ####### ## ###
 #                  ##    ## ##                                 ## ###
 ##################### ## ## ################### ############## ## ###
 ##################### ##                        ##############    ###
 #####################################################################
 #####################################################################
