 #####################################################################
 #####################################################################
 #  #   #   #   #   #   #   #       >         #   #   # ###   #   #  #
 ## # #   # # # #   # ### # #  # ## ### ### # # #   #   #   # # # # ##
 ##       #   #     < #   #                 #   #   ##  #   #   #   ##
 ##   ### #   ###  ## ### # # # # ### ### # ### # # # >   #   ### ####
 #  #   #   #   #   #   #   #         #   #   #   #   #   #   #   #  #
 ## # # # # # # #   # ### # #   # # ##    # # ###   # # # #     ### ##
 ##       #   #   #   #   #   #         #   #   #   #   #   #   #   ##
 ## #   # # ### #  ## # # # # # # ### # # # #   # # ###   # # # # # ##
 #  #   #   #       #   #   #         #   #   #           #   #   #  #
 ## # ### # # # # ### # # # #  ## #$# # # # # #   #   # # #     # # ##
 ##   #   #  ##   #   #   #       #@#   #   #   #       #       #   ##
 ## #   #     # # #   ##  # # # # #$#   ### # # # # #   #     # # # ##
 #  #   #>  #   #   #   ^   #   #     #   #   #   #   #   #   #   #  #
 ## ### #   #     # # #   # # # # ### # # # #   # # # # # ###   # # ##
 ##       #   #   #   #   #   #         #   #   #       #   #   #   ##
 ## # ###   ###     ### #   # # ### ### # #   # # # #   # #    ## # ##
 #  #   #   #   #   #   #   #             #   ##      #   #   #   #  #
 ##   #   # # # #   #   #   # #####^  ### # #   # # # ###     # # ####
 ##       #   #           #      ##         # #         #   #   #   ##
 ## # # # # # # # # # ### # ###   # ### ###%# # #   # # # # #^### # ##
 #####################################################################
 #####################################################################
