 #####################################################################
 #####################################################################
 #   ########       #######        #           #     # #######     ###
 #   #  #     ##  #  #####  ####   #    ##  ##   # #   ##    ##### ###
 #  ##    ###  ## ##  ###  ######  #   ##  ### ### ### #  ## #      ##
 # ##   #  ###  #  ##     ##    ## #  ##  ###  #     #   ##     ###  #
 # ##  ###  ## ##  ###  #    ##  # ##  ## ##  ## ### ## ## ### ##### #
 # #  #####  ###  ###  ## ##  ###  ###      #    ###    #  #    ###  #
 # # #######     ###  ###  ##  ##  ####  #### ## ### ##   ## #   ### #
 #    #####   # ###  ####   ##  ## #####  ##   #     #  ### ## #  ## #
 # ##  ###   ##  ###  #####  ##  ########    # ### ### ## # #  #  ## #
 # ##   #   ###   ###     # # ##  #############  # #          ###  # #
 # ## #####  ## #  ##    ## #                 ##     ##### ####### # #
 #        #   # ##  # # ##  #  ## ########### ##  #   ###  ##  ### # #
 ### ## ### #   ###   # #  ##### ############ # #####  #  ####  ##   #
 ### #    # # # ####  # # ##     ############ #     ##   ######  ### #
 #   #   ## # # ###  ##  ##  ################ ## ##  ## ######   # # #
 # ##### #  # # ##  ### ##  ##                #  ###  #  ####  #   # #
 #     # # ## #    ###     ###  # ### # # # # ## ##  ##       ## #   #
 #  # %# ###    # ###   ##  ##   ##@###########  ###    ##   ### ##  #
 #  #######  # ## ##  #  ##  #  # #$# # # # # ## ##### ######### ### #
 #           #  #    ###    ##     $                 # #             #
 #####################################################################
 #####################################################################
