 #####################################################################
 #####################################################################
 ##  #######   #  #  #  #         %         #  #  #  #  #  # ####   ##
 ##   #####    #  #  #  # ################# #  #  #  #  # ##  ##  ####
 ###   ###  ## #  #  #  # #               # #  #  #  #  # ###    #####
 ####   #  ### #  #  #  # # #$########### # #     #  #  #   ##  ######
 ## #     #### #  #  #  # # #           # # #  #  #  #  #    ##     ##
 ## #    ##### #  #  #  # # # ######### # # #  #  #  #  # #   # ##  ##
 ## ##         #  #  #    # # #       # # # #  #  #  #    ##    #   ##
 ## ###     ####  #  #  # # # # #$### # # # #  #  #  #  #####      ###
 ## ##    #    #  #  #  # # # # #   # # # # #  #  #  #  # ###     ####
 ## #     #### #     #  # # # # # @ # # # # #  #  #     # ####   #####
 ##     # #### #  #  #  # # # # #   # # # # #  #  #  #  # ######    ##
 ## #   #  ### # <#> # <# # # # ##### # # # #> # <#> #  # # #    #  ##
 #### ###      #  #  #  # # # #       # # # #  #  #  #  # # #  # ## ##
 ####  ###  ##    #  #  # # # #       # # #    #  #  #  # # #### #####
 ####       ## #  #  #  # # # #######$# # # #  #  #  #  #     #     ##
 ## ##  #   #  #  #  #  # # #           # # #  #  #  #  # ### ####  ##
 ##    ##      #  #     # # ############# # #  #  #  #  #   ######  ##
 ## #####   ## #  #  #  # #               $ #  #  #  #  ### #       ##
 #########  ## #  #  #  # ################# #  #  #  #  #   # # ##  ##
 ##         #  #  #  #  #                   #  #     #  # #   #     ##
 #####################################################################
 #####################################################################
