 #####################################################################
 #                               #####                               #
 #                               #   #                               #
 #                               # @ #                               #
 #    ############################   ############################    #
 #    ############################$$$############################    #
 #    #                     ####        ###                     #    #
 #    #                     ####$######$###                     #    #
 #    #                     ###  ###### ###                     #    #
 #    #  #################  ### ######  ###  #################  #    #
 #    #  #################  ### ######  ###  #################  #    #
 #    #  ##                 ###        ####                 ##  #    #
 #    #  ##                 ###        ###################  ##  #    #
 #    #  ##  ######################$######################  ##  #    #
 #    #  ##                 #######$########                ##  #    #
 #    #  #############    #$#######$########     #############  #    #
 #    #             ##    #   ###     %###       #              #    #
 #    #             ##    #   ###  #   ###       #              #    #
 #    #             ##    #   ###  #   ###       #              #    #
 #    ############  ##    #   ###  #   ###       #   ############    #
 #    ############  ##    #   ###      ###       #   ############    #
 #                  ##    #   #####  #####       #                   #
 #                  ##    #                      #                   #
 #####################################################################
