 #####################################################################
 #####################################################################
 # #######              #########    ###     ###  ################   #
 # ######  ########  ##  #######  ##  #  #  #   # #                  #
 # ###    ########  #### #####  ##     ###    $   ################   #
 # ### ##  ######  ######  ### ###  ######   #@#  #                  #
 # ##   ##  ####  ##   ###  #  ##  ######     $   ################   #
 #    #  ##      ##  #  ###       ######    #   # #                  #
 #   ###  ####  ##  ###  ###   ##  ####  ##  ###  ################   #
 #  #####  ### ##    #         ###  ##    ##  #  ##                  #
 # #######      ##     # ####   ###    ##  ## #   ################   #
 # ######## ###  ##   #  ###     ###  ###   # ### #                  #
 # ########  ###  ####  ###    #  #   ##  #   #   ################   #
 # ########   ###      ###    ###     #  ###  # ###                  #
 # ### #### #  #### ## ##  # ##### #    ##### #   ################   #
 # ##   ### ##  ### ## #     ###   ## #####   ### #                  #
 # #  #  ## ###  ##      # #  #  #  #  ###  # #   ################   #
 # # ###  #  ###  ####  ## ##   ## ##   #  ## # ###                  #
 #  #####     ### #### ##   ## ##  #  #   ### #   ################   #
 #########     ##  ### #  #          ###  ##  ### #                  #
 ##########         ##   ###  ###########     #   ################   #
 ##################     #####     %########## #                      #
 #####################################################################
 #####################################################################
