 #####################################################################
 #                        #        @        #                        #
 #                        #                 #                        #
 #                        #                 #                        #
 #                        #                 #                        #
 #                        #                 #                        #
 #                        #$$$$$$$$$$$$$$$$$#                        #
 #                        #                 #                        #
 #                        #                 #                        #
 #                        #                 #                        #
 #           ##############                 ##############           #
 #                                                                   #
 #                                                                   #
 #                                                                   #
 #                                  %                                #
 #                                                                   #
 #                                                                   #
 #                                                                   #
 #                                                                   #
 #                                                                   #
 #                                                                   #
 #                                                                   #
 #                                                                   #
 #####################################################################
